1111111111
1000001101
10P0C01E01
1000001101
1000000001
1000000A01
1000000001
10C0000001
1000000001
1111111111
